11111111111
10100000001
10P10000001
100000C0001
10000000011
100C0000001
100000000E1
11111111111