11111111111
11110000C01
11C11000001
11010000C01
11010000011
10000P00001
1E000000001
11111111111