11111111111
10000000001
10P00000001
100000C0001
10X00000011
100C00X0001
100000000E1
11111111111