11111111111
10100000001
10P10000001
100000C0001
10X00000011
100C00X0001
100000000E0
11111111111